111111111111111111111111111
1C00000000000000000000000C1
101000000000000000000000001
1C00000000000000000000000C1
101000000000000000000000011
1C1C1E0C0C0C0C0C0C0C0C1C1C1
101010000000000000000000001
1C1C0C0C0C0C0C0C0C0C0C1C101
101100000000000000000000001
1C1000000000000000000000001
111000000000000000000000001
1P00000000000000000000000C1
111111111111111111111111111