111111111111111111111111111
1C0X000000000000000000000C1
1010000000000000000000X0001
1C00000000000000000000000C1
1010X000000000000000000X011
1C1C1E0C0C0C0C0C0C0C0C1C1C1
101010000000000000000000001
1C1C0C0C0C0C0C0C0C0C0C1C101
1011000000000000000000X0001
1C1000000000000000000000001
111000000000000000000000001
1P00000000000000000000000C1
111111111111111111111111111